0111111111111111111111111111111
0111111000111111111111111111111
0111111010111111111111111111110
0000000010000000000000111111100
0111111000111111111110111111101
0000000011111111111110111000001
1111111111111111111110001011111
1111111111111111111111101011111
1111111111111111111111101000111
1111111111111111111111101101111
1111111111111111111111100001111
1111111111111100000000001111111
1111111111111101111110111111111
1111110000000000000000000000000
1111110111111111111111111111110
1111110111111111111111111111110
1111110111111111111111111111110
1111110111111111111111111110000
1111110000000000000000000000111
1111110111111111111111111110111
1111110111111111111111111110111
1111110111111111111111111110111
0000000111111111111111111110000
1111111111111111111111111111111