0000000000000000000001111111110
1111111111111111111101111000000
1000100000000000000101111011110
1010101111110111111101111011111
1010101111110000000001111011111
1010101111111111111111111011111
1010001111000000000000000011111
1011111111011111111111111111111
1000000000011111110000000000011
1111111111011111110111111111011
1000001111011111110111111111011
1011101111011111110111111111001
1011100000011111110000000001101
1011111111111111111111111101101
1000000000000000000000000001101
1111011111111111111111111111100
1111011111111000111111111111110
1111011111111010111110000011100
1111000000000010111110111000001
1111111111111110111110111111111
1111111111111110111110000001111
1100000000000000111111111101111
0001111111111111111111111100000
1111111111111111111111111111111