0111111111111111111111111111111
0111111111111000000001000000000
0111111111111011111100011111110
0000111000000000000111111111100
1110111000111111111111111111101
0000000011111111111111111000001
1011111111111111111111111011111
1011111111111111111111111011111
1011111111111111111111111001111
1000000000000000000000001101111
1111101111111111111111100001111
1111101111111100000000000111111
1111101111111111111111111111111
1111100000000000000000000000000
1111110111111111111111111111110
1111110111111111111111111111110
1111110111111111111111111111110
1111100111111111111111111110000
1111101111111111111111100000111
1111100111111111111111111110111
1111110111111111111111111110111
1111110111111111111111111110111
0000000111111111111111111110000
1111111111111111111111111111111